0 h 2 3 5 1 h 4 1 2
0 h 2 3 5 1 h 3 3 2
0 h 2 3 1 1 h 2 3 1
0 h 2 3 5 1 v 3 1 1
0 h 2 3 5 1 v 3 1 3
0 h 8 7 2 1 v 10 7 6
0 h 2 3 5 1 v 3 1 2
0 h 4 3 3 2 v 6 2 2
0 v 3 3 2 1 v 3 5 2
0 h 1 3 2 1 h 5 3 2